Z	Z, the twenty-sixth and last letter of the English alphabet, is a vocal consonant. It is taken from the Latin letter Z, which came from the Greek alphabet, this having it from a Semitic source. The ultimate origin is probably Egyptian. Etymologically, it is most closely related to s, y, and j; as in glass, glaze; E. yoke, Gr. /, L. yugum; E. zealous, jealous.  See Guide to Pronunciation, // 273, 274.
Za	An old solfeggio name for B flat; the seventh harmonic, as heard in the or aeolian string; -- so called by Tartini. It was long considered a false, but is the true note of the chord of the flat seventh.
Zabaism	Alt. of Zabism
Zabism	See Sabianism.
Zabian	See Sabian.
Zacco	See Zocco.
Zachun	An oil pressed by the Arabs from the fruit of a small thorny tree (Balanites Aegyptiaca), and sold to piligrims for a healing ointment.
Zaerthe	Same as Z/rthe.
Zaffer	A pigment obtained, usually by roasting cobalt glance with sand or quartz, as a dark earthy powder. It consists of crude cobalt oxide, or of an impure cobalt arseniate. It is used in porcelain painting, and in enameling pottery, to produce a blue color, and is often confounded with smalt, from which, however, it is distinct, as it contains no potash. The name is often loosely applied to mixtures of zaffer proper with silica, or oxides of iron, manganese, etc.
Zaim	A Turkish chief who supports a mounted militia bearing the same name.
Zaimet	A district from which a Zaim draws his revenue.
Zain	A horse of a dark color, neither gray nor white, and having no spots.
Zalambdodont	Of or pertaining to a tribe (Zalambdodonta) of Insectivora in which the molar teeth have but one V-shaped ridge.
Zalambdodont	One of the Zalambdodonta. The tenrec, solenodon, and golden moles are examples.
Zamang	An immense leguminous tree (Pithecolobium Saman) of Venezuela. Its branches form a hemispherical mass, often one hundred and eighty feet across. The sweet pulpy pods are used commonly for feeding cattle. Also called rain tree.
Zambos	of Zambo
Zambo	The child of a mulatto and a negro; also, the child of an Indian and a negro; colloquially or humorously, a negro; a sambo.
Zamia	A genus of cycadaceous plants, having the appearance of low palms, but with exogenous wood.  See Coontie, and Illust. of Strobile.
Zamindar	A landowner; also, a collector of land revenue; now, usually, a kind of feudatory recognized as an actual proprietor so long as he pays to the government a certain fixed revenue.
Zamindary	Alt. of Zamindari
Zamindari	The jurisdiction of a zamindar; the land possessed by a zamindar.
Zamite	A fossil cycad of the genus Zamia.
Zamouse	A West African buffalo (Bubalus brachyceros) having short horns depressed at the base, and large ears fringed internally with three rows of long hairs. It is destitute of a dewlap. Called also short-horned buffalo, and bush cow.
Zampogna	A sort of bagpipe formerly in use among Italian peasants. It is now almost obsolete.
Zander	A European pike perch (Stizostedion lucioperca) allied to the wall-eye; -- called also sandari, sander, sannat, schill, and zant.
Zandmole	The sand mole.
Zante	See Zantewood.
Zante currant	A kind of seedless grape or raisin; -- so called from Zante, one of the Ionian Islands.
Zantewood	A yellow dyewood; fustet; -- called also zante, and zante fustic.  See Fustet, and the Note under Fustic.
Zantewood	Satinwood (Chloroxylon Swietenia).
Zantiot	A native or inhabitant of Zante, one of the Ionian Islands.
Zanies	of Zany
Zany	A merry-andrew; a buffoon.
Zany	To mimic.
Zanyism	State or character of a zany; buffoonery.
Zaphara	Zaffer.
Zaphrentis	An extinct genus of cyathophylloid corals common in the Paleozoic formations. It is cup-shaped with numerous septa, and with a deep pit in one side of the cup.
Zapotilla	See Sapodilla.
Zaptiah	A Turkish policeman.
Zarathustrian	Alt. of Zarathustric
Zarathustric	Of or pertaining to Zarathustra, or Zoroaster; Zoroastrian.
Zarathustrism	See Zoroastrianism.
Zaratite	A hydrous carbonate of nickel occurring as an emerald-green incrustation on chromite; -- called also emerald nickel.
Zareba	An improvised stockade; especially, one made of thorn bushes, etc.
Zarnich	Native sulphide of arsenic, including sandarach, or realgar, and orpiment.
Zarthe	A European bream (Abramis vimba).
Zati	A species of macaque (Macacus pileatus) native of India and Ceylon. It has a crown of long erect hair, and tuft of radiating hairs on the back of the head. Called also capped macaque.
Zauschneria	A genus of flowering plants.  Zauschneria Californica is a suffrutescent perennial, with showy red flowers much resembling those of the garden fuchsia.
Zax	A tool for trimming and puncturing roofing slates.
Zayat	A public shed, or portico, for travelers, worshipers, etc.
Zea	A genus of large grasses of which the Indian corn (Zea Mays) is the only species known. Its origin is not yet ascertained.  See Maize.
Zeal	Passionate ardor in the pursuit of anything; eagerness in favor of a person or cause; ardent and active interest; engagedness; enthusiasm; fervor.
Zeal	A zealot.
Zeal	To be zealous.
Zealant	One who is zealous; a zealot; an enthusiast.
Zealed	Full of zeal; characterized by zeal.
Zealful	Full of zeal.
Zealless	Wanting zeal.
Zealot	One who is zealous; one who engages warmly in any cause, and pursues his object with earnestness and ardor; especially, one who is overzealous, or carried away by his zeal; one absorbed in devotion to anything; an enthusiast; a fanatical partisan.
Zealotical	Like, or suitable to, a zealot; ardently zealous.
Zealotism	The character or conduct of a zealot; zealotry.
Zealotist	A zealot.
Zealotry	The character and behavior of a zealot; excess of zeal; fanatical devotion to a cause.
Zealous	Filled with, or characterized by, zeal; warmly engaged, or ardent, in behalf of an object.
Zealous	Filled with religious zeal.
Zebec	See Xebec.
Zebra	Either one of two species of South African wild horses remarkable for having the body white or yellowish white, and conspicuously marked with dark brown or brackish bands.
Zebrawood	A kind of cabinet wood having beautiful black, brown, and whitish stripes, the timber of a tropical American tree (Connarus Guianensis).
Zebrawood	The wood of a small West Indian myrtaceous tree (Eugenia fragrans).
Zebrawood	The wood of an East Indian tree of the genus Guettarda.
Zebrine	Pertaining to, or resembling, the zebra.
Zebu	A bovine mammal (Ros Indicus) extensively domesticated in India, China, the East Indies, and East Africa. It usually has short horns, large pendulous ears, slender legs, a large dewlap, and a large, prominent hump over the shoulders; but these characters vary in different domestic breeds, which range in size from that of the common ox to that of a large mastiff.
Zebub	A large noxious fly of Abyssinia, which like the tsetse fly, is destructive to cattle.
Zechin	See Sequin.
Zechstein	The upper division of the Permian (Dyas) of Europe. The prevailing rock is a magnesian limestone.
Zed	The letter Z; -- called also zee, and formerly izzard.
Zedoary	A medicinal substance obtained in the East Indies, having a fragrant smell, and a warm, bitter, aromatic taste. It is used in medicine as a stimulant.
Zeekoe	A hippopotamus.
Zehner	An Austrian silver coin equal to ten kreutzers, or about five cents.
Zein	A nitrogenous substance of the nature of gluten, obtained from the seeds of Indian corn (Zea) as a soft, yellowish, amorphous substance.
Zemindar	Same as Zamindar.
Zemindary	Alt. of Zemindari
Zemindari	Same as Zamindary.
Zemni	The blind mole rat (Spalax typhlus), native of Eastern Europe and Asia. Its eyes and ears are rudimentary, and its fur is soft and brownish, more or less tinged with gray. It constructs extensive burrows.
Zenana	The part of a dwelling appropriated to women.
Zend	Properly, the translation and exposition in the Huzv/resh, or literary Pehlevi, language, of the Avesta, the Zoroastrian sacred writings; as commonly used, the language (an ancient Persian dialect) in which the Avesta is written.
Zend-Avesta	The sacred writings of the ancient Persian religion, attributed to Zoroaster, but chiefly of a later date.
Zendik	An atheist or unbeliever; -- name given in the East to those charged with disbelief of any revealed religion, or accused of magical heresies.
Zenick	A South African burrowing mammal (Suricata tetradactyla), allied to the civets. It is grayish brown, with yellowish transverse stripes on the back. Called also suricat.
Zenik	See Zenick.
Zenith	That point in the visible celestial hemisphere which is vertical to the spectator; the point of the heavens directly overhead; -- opposed to nadir.
Zenith	hence, figuratively, the point of culmination; the greatest height; the height of success or prosperity.
Zenithal	Of or pertaining to the zenith.
Zeolite	A term now used to designate any one of a family of minerals, hydrous silicates of alumina, with lime, soda, potash, or rarely baryta. Here are included natrolite, stilbite, analcime, chabazite, thomsonite, heulandite, and others. These species occur of secondary origin in the cavities of amygdaloid, basalt, and lava, also, less frequently, in granite and gneiss. So called because many of these species intumesce before the blowpipe.
Zeolitic	Of or pertaining to a zeolite; consisting of, or resembling, a zeolite.
Zeolitiform	Having the form of a zeolite.
Zephyr	The west wind; poetically, any soft, gentle breeze.
Zephyrus	The west wind, or zephyr; -- usually personified, and made the most mild and gentle of all the sylvan deities.
Zequin	See Sequin.
Zerda	The fennec.
Zeriba	Same as Zareba.
Zeros	of Zero
Zeroes	of Zero
Zero	A cipher; nothing; naught.
Zero	The point from which the graduation of a scale, as of a thermometer, commences.
Zero	Fig.: The lowest point; the point of exhaustion; as, his patience had nearly reached zero.
Zest	A piece of orange or lemon peel, or the aromatic oil which may be squeezed from such peel, used to give flavor to liquor, etc.
Zest	Hence, something that gives or enhances a pleasant taste, or the taste itself; an appetizer; also, keen enjoyment; relish; gusto.
Zest	The woody, thick skin inclosing the kernel of a walnut.
Zested	of Zest
Zesting	of Zest
Zest	To cut into thin slips, as the peel of an orange, lemon, etc.; to squeeze, as peel, over the surface of anything.
Zest	To give a relish or flavor to; to heighten the taste or relish of; as, to zest wine.
Zeta	A Greek letter  corresponding to our z.
Zetetic	Seeking; proceeding by inquiry.
Zetetic	A seeker; -- a name adopted by some of the Pyrrhonists.
Zetetics	A branch of algebra which relates to the direct search for unknown quantities.
Zeuglodon	A genus of extinct Eocene whales, remains of which have been found in the Gulf States. The species had very long and slender bodies and broad serrated teeth.  See Phocodontia.
Zeuglodont	Any species of Zeuglodonta.
Zeuglodonta	Same as Phocodontia.
Zeugma	A figure by which an adjective or verb, which agrees with a nearer word, is, by way of supplement, referred also to another more remote; as, "hic illius arma, hic currus fuit;" where fuit, which agrees directly with currus, is referred also to arma.
Zeugmatic	Of or pertaining to zeugma; characterized by zeugma.
Zeugobranchiata	Same as Zygobranchia.
Zeus	The chief deity of the Greeks, and ruler of the upper world (cf. Hades). He was identified with Jupiter.
Zeuzerian	Any one of a group of bombycid moths of which the genus Zeuzera is the type. Some of these moths are of large size. The goat moth is an example.
Zeylanite	See Ceylanite.
Zibet	Alt. of Zibeth
Zibeth	A carnivorous mammal (Viverra zibetha) closely allied to the civet, from which it differs in having the spots on the body less distinct, the throat whiter, and the black rings on the tail more numerous.
Ziega	Curd produced from milk by adding acetic acid, after rennet has ceased to cause coagulation.
Zietrisikite	A mineral wax, vert similar to ozocerite. It is found at Zietrisika, Moldavia, whence its name.
Zif	The second month of the Jewish ecclesiastical year, corresponding to our May.
Zigger	Alt. of Zighyr
Zighyr	Same as Sicker.
Zigzag	Something that has short turns or angles.
Zigzag	A molding running in a zigzag line; a chevron, or series of chevrons.  See Illust. of Chevron, 3.
Zigzag	See Boyau.
Zigzag	Having short, sharp turns; running this way and that in an onward course.
Zigzagged	of Zigzag
Zigzagging	of Zigzag
Zigzag	To form with short turns.
Zigzag	To move in a zigzag manner; also, to have a zigzag shape.
Zigzaggery	The quality or state of being zigzag; crookedness.
Zigzaggy	Having sharp turns.
Zilla	A low, thorny, suffrutescent, crucifeous plant (Zilla myagroides) found in the deserts of Egypt. Its leaves are boiled in water, and eaten, by the Arabs.
Zillah	A district or local division, as of a province.
Zimb	A large, venomous, two-winged fly, native of Abyssinia. It is allied to the tsetse fly, and, like the latter, is destructive to cattle.
Ziment-water	A kind of water found in copper mines; water impregnated with copper.
Zinc	An abundant element of the magnesium-cadmium group, extracted principally from the minerals zinc blende, smithsonite, calamine, and franklinite, as an easily fusible bluish white metal, which is malleable, especially when heated. It is not easily oxidized in moist air, and hence is used for sheeting, coating galvanized iron, etc. It is used in making brass, britannia, and other alloys, and is also largely consumed in electric batteries. Symbol Zn. Atomic weight 64.9.
Zincked	of Zinc
Zinced	of Zinc
Zincking	of Zinc
Zincing	of Zinc
Zinc	To coat with zinc; to galvanize.
Zincane	Zinc chloride.
Zincic	Pertaining to, containing, or resembling, zinc; zincous.
Zincide	A binary compound of zinc.
Zinciferous	Containing or affording zinc.
Zincification	The act or process of applying zinc; the condition of being zincified, or covered with zinc; galvanization.
Zincify	To coat or impregnate with zinc.
Zincite	Native zinc oxide; a brittle, translucent mineral, of an orange-red color; -- called also red zinc ore, and red oxide of zinc.
Zincking	Alt. of Zincing
Zincing	The act or process of applying zinc; galvanization.
Zincky	Pertaining to zinc, or having its appearance.
Zinco-	A combining form from zinc; in chemistry, designating zinc as an element of certain double compounds. Also used adjectively.
Zincode	The positive electrode of an electrolytic cell; anode.
Zincographer	An engraver on zinc.
Zincongraphic	Alt. of Zincongraphical
Zincongraphical	Of or pertaining to zincography; as, zincographic processes.
Zincography	The art or process of engraving or etching on zinc, in which the design is left in relief in the style of a wood cut, the rest of the ground being eaten away by acid.
Zincoid	Pertaining to, or resembling, zinc; -- said of the electricity of the zincous plate in connection with a copper plate in a voltaic circle; also, designating the positive pole.
Zinco-polar	Electrically polarized like the surface of the zinc presented to the acid in a battery, which has zincous affinity.
Zincous	Of, pertaining to, or containing, zinc; zincic; as, zincous salts.
Zincous	Hence, formerly, basic, basylous, as opposed to chlorous.
Zincous	Of or pertaining to the positive pole of a galvanic battery; electro-positive.
Zingari	of Zingaro
Zingaro	A gypsy.
Zingel	A small, edible, freshwater European perch (Aspro zingel), having a round, elongated body and prominent snout.
Zingiberaceous	Of or pertaining to ginger, or to a tribe (Zingibereae) of endogenous plants of the order Scitamineae.  See Scitamineous.
Zink	See Zinc.
Zinkenite	A steel-gray metallic mineral, a sulphide of antimony and lead.
Zinky	See Zincky.
Zinnia	Any plant of the composite genus Zinnia, Mexican herbs with opposite leaves and large gay-colored blossoms. Zinnia elegans is the commonest species in cultivation.
Zinnwaldite	A kind of mica containing lithium, often associated with tin ore.
Zinsang	The delundung.
Zinziberaceous	Same as Zingiberaceous.
Zion	A hill in Jerusalem, which, after the capture of that city by the Israelites, became the royal residence of David and his successors.
Zion	Hence, the theocracy, or church of God.
Zion	The heavenly Jerusalem; heaven.
Ziphioid	See Xiphioid.
Zirco-	A combining form (also used adjectively) designating zirconium as an element of certain double compounds; zircono-; as in zircofluoric acid, sodium zircofluoride.
Zircofluoride	A double fluoride of zirconium and hydrogen, or some other positive element or radical; as, zircofluoride of sodium.
Zircon	A mineral occurring in tetragonal crystals, usually of a brown or gray color. It consists of silica and zirconia.  A red variety, used as a gem, is called hyacinth. Colorless, pale-yellow or smoky-brown varieties from Ceylon are called jargon.
Zircona	Zirconia.
Zirconate	A salt of zirconic acid.
Zirconia	The oxide of zirconium, obtained as a white powder, and possessing both acid and basic properties. On account of its infusibility, and brilliant luminosity when incandescent, it is used as an ingredient of sticks for the Drummomd light.
Zirconic	Pertaining to, containing, or resembling, zirconium; as, zirconic oxide; zirconic compounds.
Zirconium	A rare element of the carbon-silicon group, intermediate between the metals and nonmetals, obtained from the mineral zircon as a dark sooty powder, or as a gray metallic crystalline substance. Symbol Zr. Atomic weight, 90.4.
Zircono	See Zirco-.
Zirconoid	A double eight-sided pyramid, a form common with tetragonal crystals; -- so called because this form often occurs in crystals of zircon.
Zither	An instrument of music used in Austria and Germany. It has from thirty to forty wires strung across a shallow sounding-board, which lies horizontally on a table before the performer, who uses both hands in playing on it. [Not to be confounded with the old lute-shaped cittern, or cithern.]
Zittern	See Cittern.
Zizania	A genus of grasses including Indian rice.  See Indian rice, under Rice.
Zizel	The suslik.
Zoanthacea	A suborder of Actinaria, including Zoanthus and allied genera, which are permanently attached by their bases.
Zoantharia	Same as Anthozoa.
Zoantharian	Of or pertaining to the Zoantharia.
Zoantharian	One of the Anthozoa.
Zoanthodeme	The zooids of a compound anthozoan, collectively.
Zoanthoid	Of or pertaining to the Zoanthacea.
Zoanthropy	A kind of monomania in which the patient believes himself transformed into one of the lower animals.
Zoanthus	A genus of Actinaria, including numerous species, found mostly in tropical seas. The zooids or polyps resemble small, elongated actinias united together at their bases by fleshy stolons, and thus forming extensive groups. The tentacles are small and bright colored.
Zobo	A kind of domestic cattle reared in Asia for its flesh and milk. It is supposed to be a hybrid between the zebu and the yak.
Zocle	Same as Socle.
Zocco	Alt. of Zoccolo
Zoccolo	Same as Socle.
Zodiac	An imaginary belt in the heavens, 16¡ or 18¡ broad, in the middle of which is the ecliptic, or sun's path. It comprises the twelve constellations, which one constituted, and from which were named, the twelve signs of the zodiac.
Zodiac	A figure representing the signs, symbols, and constellations of the zodiac.
Zodiac	A girdle; a belt.
Zodiacal	Of or pertaining to the zodiac; situated within the zodiac; as, the zodiacal planets.
Zoea	A peculiar larval stage of certain decapod Crustacea, especially of crabs and certain Anomura.
Zoetrope	An optical toy, in which figures made to revolve on the inside of a cylinder, and viewed through slits in its circumference, appear like a single figure passing through a series of natural motions as if animated or mechanically moved.
Zohar	A Jewish cabalistic book attributed by tradition to Rabbi Simon ben Yochi, who lived about the end of the 1st century, a. d.  Modern critics believe it to be a compilation of the 13th century.
Zoic	Of or pertaining to animals, or animal life.
Zoide	See Meride.
Zoilean	Having the characteristic of Zoilus, a bitter, envious, unjust critic, who lived about 270 years before Christ.
Zoilism	Resemblance to Zoilus in style or manner; carping criticism; detraction.
Zoisite	A grayish or whitish mineral occurring in orthorhombic, prismatic crystals, also in columnar masses. It is a silicate of alumina and lime, and is allied to epidote.
Zokor	An Asiatic burrowing rodent (Siphneus aspalax) resembling the mole rat. It is native of the Altai Mountains.
Zollverein	Literally, a customs union; specifically, applied to the several customs unions successively formed under the leadership of Prussia among certain German states for establishing liberty of commerce among themselves and common tariff on imports, exports, and transit.
Zomboruk	See Zumbooruk.
Zonae	of Zona
Zona	A zone or band; a layer.
Zonal	Of or pertaining to a zone; having the form of a zone or zones.
Zonar	A belt or girdle which the Christians and Jews of the Levant were obliged to wear to distinguish them from Mohammedans.
Zonaria	A division of Mammalia in which the placenta is zonelike.
Zonate	Divided by parallel planes; as, zonate tetraspores, found in certain red algae.
Zone	A girdle; a cincture.
Zone	One of the five great divisions of the earth, with respect to latitude and temperature.
Zone	The portion of the surface of a sphere included between two parallel planes; the portion of a surface of revolution included between two planes perpendicular to the axis.
Zone	A band or stripe extending around a body.
Zone	A band or area of growth encircling anything; as, a zone of evergreens on a mountain; the zone of animal or vegetable life in the ocean around an island or a continent; the Alpine zone, that part of mountains which is above the limit of tree growth.
Zone	A series of planes having mutually parallel intersections.
Zone	Circuit; circumference.
Zone	To girdle; to encircle.
Zoned	Wearing a zone, or girdle.
Zoned	Having zones, or concentric bands; striped.
Zoned	Zonate.
Zoneless	Not having a zone; ungirded.
Zonnar	See Zonar.
Zonular	Of or pertaining to a zone; zone-shaped.
Zonule	A little zone, or girdle.
Zonulet	A zonule.
Zonure	Any one of several of South African lizards of the genus Zonura, common in rocky situations.
Zoo-	A combining form from Gr. zwo^,n an animal, as in zoogenic, zoology, etc.
Zoochemical	Pertaining to zoochemistry.
Zoochemistry	Animal chemistry; particularly, the description of the chemical compounds entering into the composition of the animal body, in distinction from biochemistry.
Zoochemy	Animal chemistry; zoochemistry.
Zoochlorella	One of the small green granulelike bodies found in the interior of certain stentors, hydras, and other invertebrates.
Zoocyst	A cyst formed by certain Protozoa and unicellular plants which the contents divide into a large number of granules, each of which becomes a germ.
Zoocytia	of Zoocytium
Zoocytium	The common support, often branched, of certain species of social Infusoria.
Zoodendria	of Zoodendrium
Zoodendrium	The branched, and often treelike, support of the colonies of certain Infusoria.
Zooecia	of Zooecium
Zooecium	One of the cells or tubes which inclose the feeling zooids of Bryozoa.  See Illust. of Sea Moss.
Zooerythrine	A peculiar organic red coloring matter found in the feathers of various birds.
Zoogamous	Of or pertaining zoogamy.
Zoogamy	The sexual reproduction of animals.
Zoogenic	Of or pertaining to zoogeny, animal production.
Zoogeny	Alt. of Zoogony
Zoogony	The doctrine of the formation of living beings.
Zoogeography	The study or description of the geographical distribution of animals.
Zoogeographical	Of or pertaining to zoography.
Zoogloea	A colony or mass of bacteria imbedded in a viscous gelatinous substance. The zoogloea is characteristic of a transitory stage through which rapidly multiplying bacteria pass in the course of their evolution. Also used adjectively.
Zoographer	One who describes animals, their forms and habits.
Zoographic	Alt. of Zoographical
Zoographical	Of or pertaining to the description of animals.
Zoographist	A zoographer.
Zoography	A description of animals, their forms and habits.
Zooid	Pertaining to, or resembling, an animal.
Zooid	An organic body or cell having locomotion, as a spermatic cell or spermatozooid.
Zooid	An animal in one of its inferior stages of development, as one of the intermediate forms in alternate generation.
Zooid	One of the individual animals in a composite group, as of Anthozoa, Hydroidea, and Bryozoa; -- sometimes restricted to those individuals in which the mouth and digestive organs are not developed.
Zooidal	Of or pertaining to a zooid; as, a zooidal form.
Zoolatry	The worship of animals.
Zoologer	A zoologist.
Zoological	Of or pertaining to zoology, or the science of animals.
Zoologically	In a zoological manner; according to the principles of zoology.
Zoologist	One who is well versed in zoology.
Zoologies	of Zoology
Zoology	That part of biology which relates to the animal kingdom, including the structure, embryology, evolution, classification, habits, and distribution of all animals, both living and extinct.
Zoology	A treatise on this science.
Zoomelanin	A pigment giving the black color to the feathers of many birds.
Zoomorphic	Of or pertaining to zoomorphism.
Zoomorphism	The transformation of men into beasts.
Zoomorphism	The quality of representing or using animal forms; as, zoomorphism in ornament.
Zoomorphism	The representation of God, or of gods, in the form, or with the attributes, of the lower animals.
Zoa	of Zoon
Zoon	An animal which is the sole product of a single egg; -- opposed to zooid.
Zoon	Any one of the perfectly developed individuals of a compound animal.
Zoonic	Of or pertaining to animals; obtained from animal substances.
Zoonite	One of the segments of the body of an articulate animal.
Zoonite	One of the theoretic transverse divisions of any segmented animal.
Zoonomy	The laws of animal life, or the science which treats of the phenomena of animal life, their causes and relations.
Zoonule	Same as Zoonite.
Zoopathology	Animal pathology.
Zoophaga	An artificial group comprising various carnivorous and insectivorous animals.
Zoophagan	A animal that feeds on animal food.
Zoophagous	Feeding on animals.
Zoophilist	A lover of animals.
Zoophily	Love of animals.
Zoophite	A zoophyte.
Zoophoric	Bearing or supporting the figure of an animal; as, a zoophoric column.
Zoophorous	The part between the architrave and cornice; the frieze; -- so called from the figures of animals carved upon it.
Zoophyta	An extensive artificial and heterogeneous group of animals, formerly adopted by many zoologists. It included the c/lenterates, echinoderms, sponges, Bryozoa, Protozoa, etc.
Zoophyte	Any one of numerous species of invertebrate animals which more or less resemble plants in appearance, or mode of growth, as the corals, gorgonians, sea anemones, hydroids, bryozoans, sponges, etc., especially any of those that form compound colonies having a branched or treelike form, as many corals and hydroids.
Zoophyte	Any one of the Zoophyta.
Zoophytic	Alt. of Zoophytical
Zoophytical	Of or pertaining to zoophytes.
Zoophytoid	Pertaining to, or resembling, a zoophyte.
Zoophytological	Of or pertaining to zoophytology; as, zoophytological observations.
Zoophytology	The natural history zoophytes.
Zoopraxiscope	An instrument similar to, or the same as, the, the phenakistoscope, by means of which pictures projected upon a screen are made to exhibit the natural movements of animals, and the like.
Zoopsychology	Animal psychology.
Zoosperm	One of the spermatic particles; spermatozoid.
-sporangia	of Zoosporangium
Zoosporangium	A spore, or conceptacle containing zoospores.
Zoospore	A spore provided with one or more slender cilia, by the vibration of which it swims in the water. Zoospores are produced by many green, and by some olive-brown, algae. In certain species they are divided into the larger macrozoospores and the smaller microzoospores. Called also sporozoid, and swarmspore.
Zoospore	See Swarmspore.
Zoosporic	Of or pertaining to zoospores; of the nature of zoospores.
Zootic	Containing the remains of organized bodies; -- said of rock or soil.
Zootomical	Of or pertaining to zootomy.
Zootomist	One who dissects animals, or is skilled in zootomy.
Zootomy	The dissection or the anatomy of animals; -- distinguished from androtomy.
Zootrophic	Of or pertaining to the nourishment of animals.
Zoozoo	The wood pigeon.
Zope	A European fresh-water bream (Abramis ballerus).
Zopilote	The urubu, or American black vulture.
Zoril	Same as Zorilla.
Zorilla	Either one of two species of small African carnivores of the genus Ictonyx allied to the weasels and skunks.
Zoroastrian	Of or pertaining to Zoroaster, or his religious system.
Zoroastrian	A follower of Zoroaster; one who accepts Zoroastrianism.
Zoroastrianism	The religious system of Zoroaster, the legislator and prophet of the ancient Persians, which was the national faith of Persia; mazdeism. The system presupposes a good spirit (Ormuzd) and an opposing evil spirit (Ahriman).  Cf. Fire worship, under Fire, and Parsee.
Zoroastrism	Same as Zoroastrianism.
Zoster	Shingles.
Zostera	A genus of plants of the Naiadaceae, or Pondweed family. Zostera marina is commonly known as sea wrack, and eelgrass.
Zosterops	A genus of birds that comprises the white-eyes.  See White-eye.
Zouave	One of an active and hardy body of soldiers in the French service, originally Arabs, but now composed of Frenchmen who wear the Arab dress.
Zouave	Hence, one of a body of soldiers who adopt the dress and drill of the Zouaves, as was done by a number of volunteer regiments in the army of the United States in the Civil War, 1861-65.
Zounds	An exclamation formerly used as an oath, and an expression of anger or wonder.
Zoutch	To stew, as flounders, eels, etc., with just enough or liquid to cover them.
Zubr	The aurochs.
Zuche	A stump of a tree.
Zuchetto	A skullcap covering the tonsure, worn under the berretta. The pope's is white; a cardinal's red; a bishop's purple; a priest's black.
Zufolo	A little flute or flageolet, especially that which is used to teach birds.
Zuisin	The American widgeon.
Zulus	The most important tribe belonging to the Kaffir race. They inhabit a region on the southeast coast of Africa, but formerly occupied a much more extensive country. They are noted for their warlike disposition, courage, and military skill.
Zumbooruk	A small cannon supported by a swiveled rest on the back of a camel, whence it is fired, -- used in the East.
Zumic	Alt. of Zumometer
Zumological	Alt. of Zumometer
Zumology	Alt. of Zumometer
Zumometer	See Zymic, Zymological, etc.
Zu/is	A tribe of Pueblo Indians occupying a village in New Mexico, on the Zu/i River.
Zunyite	A fluosilicate of alumina occurring in tetrahedral crystals at the Zu/i mine in Colorado.
Zwanziger	An Austrian silver coin equivalent to 20 kreutzers, or about 10 cents.
Zygantra	of Zygantrum
Zygantrum	See under Zygosphene.
Zygapophyses	of Zygapophysis
Zygapophysis	One of the articular processes of a vertebra, of which there are usually four, two anterior and two posterior.  See under Vertebra.
Zygenid	Any one of numerous species of moths of the family Zygaenidae, most of which are bright colored. The wood nymph and the vine forester are examples. Also used adjectively.
Zygobranchia	A division of marine gastropods in which the gills are developed on both sides of the body and the renal organs are also paired. The abalone (Haliotis) and the keyhole limpet (Fissurella) are examples.
Zygobranchiate	Of or pertaining to the Zygobranchia.
Zygodactyl	Alt. of Zygodactyle
Zygodactyle	Any zygodactylous bird.
Zygodactylae	The zygodactylous birds. In a restricted sense applied to a division of birds which includes the barbets, toucans, honey guides, and other related birds.
Zygodactyli	Same as Scansores.
Zygodactylic	Alt. of Zygodactylous
Zygodactylous	Yoke-footed; having the toes disposed in pairs; -- applied to birds which have two toes before and two behind, as the parrot, cuckoo, woodpecker, etc.
Zygoma	The jugal, malar, or cheek bone.
Zygoma	The zygomatic process of the temporal bone.
Zygoma	The whole zygomatic arch.
Zygomatic	Of, pertaining to, or in the region of, the zygoma.
Zygomorphic	Alt. of Zygomorphous
Zygomorphous	Symmetrical bilaterally; -- said of organisms, or parts of organisms, capable of division into two symmetrical halves only in a single plane.
Zyophyte	Any plant of a proposed class or grand division (Zygophytes, Zygophyta, or Zygosporeae), in which reproduction consists in the union of two similar cells.  Cf. Oophyte.
Zygosis	Same as Conjugation.
Zygosperm	A spore formed by the union of the contents of two similar cells, either of the same or of distinct individual plants. Zygosperms are found in certain orders of algae and fungi.
Zygosphene	A median process on the front part of the neural arch of the vertebrae of most snakes and some lizards, which fits into a fossa, called the zygantrum, on the back part of the arch in front.
Zygospore	Same as Zygosperm.
Zygospore	A spore formed by the union of several zoospores; -- called also zygozoospore.
Zylonite	Celluloid.
Zymase	A soluble ferment, or enzyme.  See Enzyme.
Zyme	A ferment.
Zyme	The morbific principle of a zymotic disease.
Zymic	Pertaining to, or produced by, fermentation; -- formerly, by confusion, used to designate lactic acid.
Zymogen	A mother substance, or antecedent, of an enzyme or chemical ferment; -- applied to such substances as, not being themselves actual ferments, may by internal changes give rise to a ferment.
Zymogene	One of a physiological group of globular bacteria which produces fermentations of diverse nature; -- distinguished from pathogene.
Zymogenic	Pertaining to, or formed by, a zymogene.
Zymogenic	Capable of producing a definite zymogen or ferment.
Zymologic	Alt. of Zymological
Zymological	Of or pertaining to zymology.
Zymologist	One who is skilled in zymology, or in the fermentation of liquors.
Zymology	A treatise on the fermentation of liquors, or the doctrine of fermentation.
Zymome	A glutinous substance, insoluble in alcohol, resembling legumin; -- now called vegetable fibrin, vegetable albumin, or gluten casein.
Zymometer	Alt. of Zymosimeter
Zymosimeter	An instrument for ascertaining the degree of fermentation occasioned by the mixture of different liquids, and the degree of heat which they acquire in fermentation.
Zymophyte	A bacteroid ferment.
Zymose	Invertin.
Zymosis	A fermentation; hence, an analogous process by which an infectious disease is believed to be developed.
Zymosis	A zymotic disease.
Zymotic	Of, pertaining to, or caused by, fermentation.
Zymotic	Designating, or pertaining to, a certain class of diseases.  See Zymotic disease, below.
Zythem	See Zythum.
Zythepsary	A brewery.
Zythum	A kind of ancient malt beverage; a liquor made from malt and wheat.
